BBBBBBBBBBBBBBBBBBBBBBBBBBBBBBBBBBBBBBBBBBBBBBBBBBBBBBBBBBBBBBBBBBBBBBBBBBBBBBBBBBBBBBBBBBBBBBBBBBBB
B00000000000000000000000000000000000000000000000000000000000000000000000000000000000000000000000000B
B00000000000000000000000000000000000000000000000000000000000000000000000000000000000000000000000000B
B00000000000000000000000000000000000000000000000000000000000000000000000000000000000000000000000000B
B00000000000000000000000000000000000000000000000000000000000000000000000000000000000000000000000000B
B00000000000000000000000000000000000000000000000000000000000000000000000000000000000000000000000000B
B00000000000000000000000000000000000000000000000000000000000000000000000000000000000000000000000000B
B00000000000000000000000000000000000000000000000000000000000000000000000000000000000000000000000000B
B00000000000000000000000000000000000000000000000000000000000000000000000000000000000000000000000000B
B00000000000000000000000000000000000000000000000000000000000000000000000000000000000000000000000000B
B00000000000000000000000000000000000000000000000000000000000000000000000000000000000000000000000000B
B00000000000000000000000000000000000000000000000000000000000000000000000000000000000000000000000000B
B00000000000000000000000000000000000000000000000000000000000000000000000000000000000000000000000000B
B00000000000000000000000000000000000000000000000000000000000000000000000000000000000000000000000000B
B00000000000000000000000000000000000000000000000000000000000000000000000000000000000000000000000000B
B00000000000000000000000000000000000000000000000000000000000000000000000000000000000000000000000000B
B00000000000000000000000000000000000000000000000000000000000000000000000000000000000000000000000000B
B00000000000000000000000000000000000000000000000000000000000000000000000000000000000000000000000000B
B00000000000000000000000000000000000000000000000000000000000000000000000000000000000000000000000000B
B00000000000000000000000000000000000000000000000000000000000000000000000000000000000000000000000000B
B00000000000000000000000000000000000000000000000000000000000000000000000000000000000000000000000000B
B00000000000000000000000000000000000000000000000000000000000000000000000000000000000000000000000000B
B00000000000000000000000000000000000000000000000000000000000000000000000000000000000000000000000000B
B00000000000000000000000000000000000000000000000000000000000000000000000000000000000000000000000000B
B00000000000000000000000000000000000000000000000000000000000000000000000000000000000000000000000000B
B00000000000000000000000000000000000000000000000000000000000000000000000000000000000000000000000000B
B00000000000000000000000000000000000000000000000000000000000000000000000000000000000000000000000000B
B00000000000000000000000000000000000000000000000000000000000000000000000000000000000000000000000000B
B00000000000000000000000000000000000000000000000000000000000000000000000000000000000000000000000000B
B00000000000000000000000000000000000000000000000000000000000000000000000000000000000000000000000000B
B00000000000000000000000000000000000000000000000000000000000000000000000000000000000000000000000000B
B00000000000000000000000000000000000000000000000000000000000000000000000000000000000000000000000000B
B00000000000000000000000000000000000000000000000000000000000000000000000000000000000000000000000000B
B00000000000000000000000000000000000000000000000000000000000000000000000000000000000000000000000000B
B00000000000000000000000000000000000000000000011100000000000000000000000000000000000000000000000000B
B00000000000000000000000000000000000000000000111111100000000000000000000000000000000000000000000000B
B00000000000000000000000000000000000000001111111111111100000000000000000000000000000000000000000000B
B00000000000000000000000000000000000000111111111111111111100000000000000000000000000000000000000000B
B00000000111000000000000000000000001111111111111111111111111100000000000000000000000011110000000000B
B00F00011111110000000000000000001111111111111111111111111111111100000000000000000001111111111000G00B
B11111111111111110000000111111111111111111111111111111111111111111111000000111111111111111111111111B
B11111111111111111100000000011111111111111111111111111111111111110000000001111111111111111111111111B
B11111111111111111110000000001111111111111111111111111111111111100000000011111111111111111111111111B
B11111111111111111111100000000000000000000000000000000000000000000000000111111111111111111111111111B
B11111111111111111111110000000000000000000000000000000000000000000000001111111111111111111111111111B
B11111111111111111111111000000000000000000000000000000000000000000000011111111111111111111111111111B
B11111111111111111111111111111111111111111111111111111111111111111111111111111111111111111111111111B
B11111111111111111111111111111111111111111111111111111111111111111111111111111111111111111111111111B
B11111111111111111111111111111111111111111111111111111111111111111111111111111111111111111111111111B
BBBBBBBBBBBBBBBBBBBBBBBBBBBBBBBBBBBBBBBBBBBBBBBBBBBBBBBBBBBBBBBBBBBBBBBBBBBBBBBBBBBBBBBBBBBBBBBBBBBB