BBBBBBBBBBBBBBBBBBBBBBBBBBBBBBBBBBBBBBBBBBBBBBBBBBBBBBBBBBBBBBBBBBBBBBBBBBBBBBBBBBBBBBBBBBBBBBBBBBBB
B00000000000000000000000000000000000000000000000000000000000000000000000000000000000000000000000000B
B00000000000000000000000000000000000000000000000000000000000000000000000000000000000000000000000000B
B00000000000000000000000000000000000000000000000000000000000000000000000000000000000000000000000000B
B00000000000000000000000000000000000000000000000000000000000000000000000000000000000000000000000000B
B00000000000000000000000000000000000000000000000000000000000000000000000000000000000000000000000000B
B00000000000000000000000000000000000000000000000000000000000000000000000000000000000000000000000000B
B00000000000000000000000000000000000000000000000000000000000000000000000000000000000000000000000000B
B00000000000000000000000000000000000000000000000000000000000000000000000000000000000000000000000000B
B00000000000000000000000000000000000000000000000000000000000000000000000000000000000000000000000000B
B00000000000000000000000000000000000000000000000000000000000000000000000000000000000000000000000000B
B00000000000000000000000000000000000000000000000000000000000000000000000000000000000000000000000000B
B00000000000000000000000000000000000000000000000000000000000000000000000000000000000000000000000000B
B00000000000000000000000000000000000000000000000000000000000000000000000000000000000000000000000000B
B00000000000000000000000000000000000000000000000000000000000000000000000000000000000000000000000000B
B00000000000000000000000000000000000000000000000000000000000000000000000000000000000000000000000000B
B00000000000000000000000000000000000000000000000000000000000000000000000000000000000000000000000000B
B00000000000000000000000000000000000000000000000000000000000000000000000000000000000000000000000000B
B00000000000000000000000000000000000000000000000000000000000000000000000000000000000000000000000000B
B00000000000000000000000000000000000000000000000000000000000000000000000000000000000000000000000000B
B00000000000000000000000000000000000000000000000000000000000000000000000000000000000000000000000000B
B00000000000000000000000000000000000000000000000000000000000000000000000000000000000000000000000000B
B00000000000000000000000000000000000000000000000000000000000000000000000000000000000000000000000000B
B00000000000000000000000000000000000000000000000000000000000000000000000000000000000000000000000000B
B00000000000000000000000000000000000000000000000000000000000000000000000000000000000000000000000000B
B00000000000000000000000000000000000000000000000000000000000000000000000000000000000000000000000000B
B00000000000000000000000000000000000000000000000000000000000000000000000000000000000000000000000000B
B00000000000000000000000000000000000000000000000000000000000000000000000000000000000000000000000000B
B00000000000000000000000000000000000000000000000000000000000000000000000000000000000000000000000000B
B00000000000000000000000000000000000000000000000000000000000000000000000000000000000000000000000000B
B00000000000000000000000000000000000000000000000000000000000000000000000000000000000000000000000000B
B00000000666660000000000000000000000000000000000000000000000000000000000000000000000000000000000000B
B00000006666666000000000000000000000000000000000000000000000000000000000000000000000000000000000000B
B00000000666660000000000000000000000000000000000000000000000000000000000000000000000000000000000000B
B00000000000000000000000000000000000000000000000000000000000000000000000000000000000000000000000000B
B00000000000000000000000000000000000000000000000000000000000000000000000000000000000000000000000000B
B00000000000000000000000000000000000000000000000000000000000000000000000000000000000000000000000000B
B00000000000000000000000000000000000000111100000000000000000000000000000000000000000000000000000000B
B00000000000000000000000000000000001111111111100000000000000000000000000000000000000000000000000000B
B00000000110000000000000000000001111111111111111111100000000000000000000000000000000000001111000000B
B11111111111111111111111111111111111111111111111111111111111111111111111111111111111111111111111111B
B11111111111111111111111111111111111111111111111111111111111111111111111111111111111111111111111111B
B11111111111111111111111111111111111111111111111111111111111111111111111111111111111111111111111111B
B11111111111111111111111111111111111111111111111111111111111111111111111111111111111111111111111111B
B11111111111111111111111111111111111111111111111111111111111111111111111111111111111111111111111111B
B11111111111111111111111111111111111111111111111111111111111111111111111111111111111111111111111111B
B11111111111111111111111111111111111111111111111111111111111111111111111111111111111111111111111111B
B11111111111111111111111111111111111111111111111111111111111111111111111111111111111111111111111111B
B11111111111111111111111111111111111111111111111111111111111111111111111111111111111111111111111111B
BBBBBBBBBBBBBBBBBBBBBBBBBBBBBBBBBBBBBBBBBBBBBBBBBBBBBBBBBBBBBBBBBBBBBBBBBBBBBBBBBBBBBBBBBBBBBBBBBBBB